NO ./textures/StoneWall_GRAYSCALE.png
SO ./textures/StoneWall_NORMAL.png
WE ./textures/StoneWall000.png
EA ./textures/StoneWall001.png
DR ./textures/proto/door.png
AS ./textures/sprite.png

F 150,150,150
C 0,0,255

        1111111111111111111111111
        1000000000110000000000001
        1011000001110000000000001
        1001000000000000000040001
111111111011000001110000000000001
100000000011000001110111111111111
11110111111111011100000010001
11110111111111011101000010001
110000001101010111001000112011
10000000000000001100000000W021
100000000000000011010000000111
1111000111010101111101111111111
11 11111 11 101111010001
 1111111 11 111111111111
