NO ./textures/proto/north.png
SO ./textures/proto/south.png
WE ./textures/proto/west.png
EA ./textures/proto/east.png

F 150,150,150
C 50,50,255

111111111111111
100000010000001
100000010000111
100000010001001
100000000000001
100100010000001
10000001000N001
111111111111111