NO ./path_to_the_north_texture
SO ./path_to_the_south_texture
WE ./path_to_the_west_texture
EA ./path_to_the_east_texture

F 20,100,0
C 0,80,80

        1111111111111111111111111
        1000000000110000000000001
        1011000001110000000000001
        1001000000000000000000001
111111111011000001110000000000001
100000000011000001110111111111111
11110111111111011100000010001
11110111111111011101000010001
11000000110101011100100011001
10000000000000001100000000W01
10000000000000001101000000011
1111000111010101111101111111111
11 11111 11 101111010001
 1111111 11 111111111111
